[[0,0,0,0,0,0,0,0,0,0,0,0,0],[2,1,2,1,2,1,2,1,2,1,2,1,2],[1,1,1,1,1,1,1,1,1,1,1,1,1],[1,2,1,2,1,2,1,2,1,2,1,2,1],[1,1,1,1,1,1,1,1,1,1,1,1,1],[1,1,1,1,1,1,1,1,1,1,1,1,1]]
[[4,1,0,0,0,0,0,0,0,0,0,0,0],[1,1,1,1,0,0,0,0,0,0,0,0,0],[1,1,1,1,1,1,0,0,0,0,0,0,0],[1,1,1,1,1,1,1,1,0,0,0,0,0],[1,1,1,1,1,1,1,1,1,1,0,0,0],[1,1,1,1,1,1,1,1,1,1,1,1,3],[2,2,2,2,2,2,2,2,2,2,2,2,3]]
[[0,0,0,0,1,0,0,0,1,0,0,0,0],[0,0,0,1,1,1,0,1,1,1,0,0,0],[0,0,0,1,1,1,1,1,1,1,0,0,0],[0,0,0,1,1,1,1,1,1,1,0,0,0],[0,0,0,1,1,1,1,1,1,1,0,0,0],[0,0,0,0,1,1,1,1,1,0,0,0,0],[0,0,0,0,0,1,1,1,0,0,0,0,0],[0,0,0,0,0,0,1,0,0,0,0,0,0]]
[[1,1,1,1,1,1,1,1,1,1,1,1,1],[1,0,0,0,0,0,0,0,0,0,0,0,1],[1,0,2,2,2,2,2,2,2,2,2,0,1],[1,0,2,3,3,3,4,3,3,3,2,0,1],[1,0,2,2,2,2,2,2,2,2,2,0,1],[1,0,0,0,0,0,0,0,0,0,0,0,1],[1,1,1,1,1,1,1,1,1,1,1,1,1]]
[[0,1,1,1,0,1,1,1,0,1,0,1,0],[0,1,0,1,0,1,0,0,0,1,0,1,0],[0,1,0,1,0,1,0,0,0,1,0,1,0],[0,1,1,1,0,1,0,1,0,1,1,1,0],[0,1,0,1,0,1,0,1,0,1,0,1,0],[0,1,0,1,0,1,0,1,0,1,0,1,0],[0,1,0,1,0,1,1,1,0,1,0,1,0]]
[[0,4,0,4,0,4,0,4,0,4,0,4,0],[0,1,0,1,0,1,0,1,0,1,0,1,0],[2,0,2,0,2,0,2,0,2,0,2,0,2],[3,0,3,0,3,0,3,0,3,0,3,0,3],[0,1,0,1,0,1,0,1,0,1,0,1,0],[0,2,0,2,0,2,0,2,0,2,0,2,0],[1,0,1,0,1,0,1,0,1,0,1,0,1],[3,0,3,0,3,0,3,0,3,0,3,0,3]]
[[1,1,1,1,1,1,1,1,1,1,1,1,1],[0,0,1,0,0,0,0,0,1,0,0,0,0],[0,2,1,2,0,1,0,2,1,2,0,1,0],[0,0,1,0,0,1,0,0,1,0,0,1,0],[2,0,1,0,2,1,2,0,1,0,2,1,0],[0,0,0,0,0,1,0,0,0,0,0,1,0],[1,1,1,1,1,1,1,1,1,1,1,1,3]]
[[0,0,0,1,0,0,0,0,0,1,0,0,0],[0,0,1,1,0,0,0,0,0,1,1,0,0],[0,1,1,1,2,2,2,2,2,1,1,1,0],[2,1,1,1,2,2,2,2,2,1,1,1,2],[0,1,1,1,2,2,2,2,2,1,1,1,0],[0,0,1,1,0,0,0,0,0,1,1,0,0],[0,0,0,1,0,0,0,0,0,1,0,0,0]]
[[0,0,0,2,0,0,0,2,0,0,0,0,0],[0,0,0,2,4,4,4,2,0,0,0,0,0],[0,0,0,2,1,1,1,2,2,0,0,0,0],[0,0,0,2,1,1,1,2,0,2,0,0,0],[0,0,0,2,1,1,1,2,0,2,0,0,0],[0,0,0,2,1,1,1,2,0,2,0,0,0],[0,0,0,2,1,1,1,2,0,2,0,0,0],[0,0,0,2,1,1,1,2,2,0,0,0,0],[0,0,0,2,1,1,1,2,0,0,0,0,0],[0,0,0,2,2,2,2,2,0,0,0,0,0]]
[[0,0,1,0,0,0,0,0,0,0,1,0,0],[0,0,1,0,2,0,0,0,2,0,1,0,0],[0,0,1,0,0,0,0,0,0,0,1,0,0],[0,0,1,0,0,0,4,0,0,0,1,0,0],[0,0,1,0,0,0,0,0,0,0,1,0,0],[0,0,1,0,0,3,3,3,0,0,1,0,0],[0,0,1,0,0,0,0,0,0,0,1,0,0],[0,0,1,1,1,1,1,1,1,1,1,0,0]]
#1-normal blocks
#2-strong blocks
#3-ghost blocks
#4-gold blocks

solid,piramida,serce,kolkowkolku,agh,po 2,slalom,sztanga,kufel,head


